%%%%%%%%%%
%W.......%
%.%%%%.%%%
%......%.%
%%%%%.%%.%
%........%
%.%.%.%..%
%P.....%.%
%%%%%%%%%%